alsSHQ	als	Albanian, Tosk	public
adt	adt	Adnyamathanha	cc
alh	alh	Alawa	cc
aly	aly	Alyawarr	cc
aoi	aoi	Anindilyakwa	cc
amx	amx	Anmatyerre	cc
are	are	Arrarnta, Western	cc
aer	aer	Arrernte, Eastern	cc
awk	awk	Awabakal	public
bvr	bvr	Burarra	cc
dwy	dwy	Dhuwaya	cc
dif	dif	Dieri	public
djr	djr	Djambarrpuyngu	cc
dhgduwadha	dhg	Djangu	cc
dhg	dhg	Djangu	cc
djj	djj	Djeebbana	cc
dji	dji	Djinang	cc
engnna	eng	English	cc
engPEV	eng	English	cc
kld	kld	Gamilaraay	public
wrk	wrk	Garrwa	cc
gnn	gnn	Gumatj	cc
gupk	gup	Gunwinggu	cc
gup	gup	Gunwinggu	cc
gue	gue	Gurinji	cc
kky	kky	Guugu Yimidhirr	public
mwp	mwp	Kala Lagaw Ya	cc
gia	gia	Kitja	cc
rop	rop	Kriol	cc
kux	kux	Kukatja	cc
gvn	gvn	Kuku-Yalanji	cc
wlg	wlg	Kunbarlang	cc
kjn	kjn	Kunjen	cc
mpj	mpj	Martu Wangka	cc
mph	mph	Maung	cc
ulk	ulk	Meriam	cc
ulk1902	ulk	Meriam	public
mwf2018	mwf	Murrinh-Patha	cc
nay	nay	Narrinyeri	public
ntj	ntj	Ngaanyatjarra	cc
nuy	nuy	Nunggubuyu	cc
nna	nna	Nyangumarta	cc
nys	nys	Nyunga	cc
piu2006	piu	Pintupi-Luritja	cc
pjt	pjt	Pitjantjatjara	cc
rmb	rmb	Rembarunga	cc
thd	thd	Thayore	cc
tiw	tiw	Tiwi	cc
tcs	tcs	Torres Strait Creole	cc
wmt	wmt	Walmajarri	cc
wbp	wbp	Warlpiri	cc
wim	wim	Wik-Mungkan	cc
wro	wro	Worrorra	public
jao	jao	Yanyuwa	cc
yij	yij	Yindjibarndi	cc
tkr	tkr	Tsakhur	cc
benirv	ben	Bengali	cc
benobcv	ben	Bengali	cc
bel	bel	Belarusian	cc
beln	bel	беларуская	cc
mopNT	mop	Maya, Mopán	cc
bba	bba	Baatonum	cc
tbzsim	tbz	Ditammari	cc
fue	fue	Fulfulde, Borgu	cc
fuhbkf	fuh	Fulfulde, Western Niger	cc
dop	dop	Lukpa	cc
mkl	mkl	Mokole	cc
cavNT	cav	Cavineña	cc
caoNT	cao	Chácobo	cc
capNT	cap	Chipaya	cc
caxNT	cax	Chiquitano	cc
eseNT	ese	Ese Ejja	cc
guiNT	gui	Guaraní, Eastern Bolivian	cc
gnwNT	gnw	Guaraní, Western Bolivian	cc
gyrNT	gyr	Guarayu	cc
ignNT	ign	Ignaciano	cc
qulNT	qul	Quechua, North Bolivian	cc
quhNT	quh	Quechua, South Bolivian	cc
srqNT	srq	Sirionó	cc
tnaNT	tna	Tacana	cc
nhr	nhr	Naro	cc
tsn	tsn	Setswana	cc
apnNT	apn	Apinayé	cc
apuNT	apu	Apurinã	cc
bkqNT	bkq	Bakairí	cc
gubBl	gub	Guajajára	cc
gun	gun	Guaraní, Mbyá	cc
hixNT	hix	Hixkaryána	cc
urbNT	urb	Kaapor	cc
kbcNT	kbc	Kadiwéu	cc
kgpNT	kgp	Kaingang	cc
kgkNT	kgk	Kaiwá	cc
kpjNT	kpj	Karajá	cc
kyzNT	kyz	Kayabí	cc
txuNT	txu	Kayapó	cc
mbcNT	mbc	Macushi	cc
mblNT	mbl	Maxakalí	cc
myu	myu	Mundurukú	cc
mbjNT	mbj	Nadeb	cc
plu	plu	Palikúr	cc
pabNT	pab	Parecís	cc
padNT	pad	Paumarí	cc
porblt	por	Português	cc
porbr2018	por	Portuguese	cc
porbrbsl	por	Portuguese	public
portft	por	Portuguese	cc
rkbNT	rkb	Rikbaktsa	cc
mavNT	mav	Sateré-Mawé	cc
pahNT	pah	Tenharim	cc
terNT	ter	Terêna	cc
tuoNT	tuo	Tucano	cc
xavNT	xav	Xavánte	cc
boxNT	box	Buamu	cc
gux	gux	Gourmanchéma	cc
guxg	gux	Gourmanchéma	cc
bssNT	bss	Akoose	cc
anvNT	anv	Denya	cc
xed	xed	Hdi	cc
kenNT	ken	Kenyang	cc
mcp	mcp	Makaa	cc
mqbNT	mqb	Mbuko	cc
meq	meq	Merey	cc
muy	muy	Muyang	cc
nhuNT	nhu	Noone	cc
alqALGNT	alq	Algonquin	cc
bea	bea	Beaver	public
bla	bla	Blackfoot	public
crxNTpo	crx	Carrier	cc
cafNT	caf	Carrier, Southern	cc
dgrDOGNT	dgr	Dogrib	cc
micMIQNT	mic	Mi'kmaq	cc
bjvNT	bjv	Bedjond	cc
daaNT	daa	Dangaléat	cc
kyq	kyq	Kenga	cc
arnNT	arn	Mapudungun	cc
cmn-cu89s	cmn	Chinese	public
cmn-cu89t	cmn	Chinese	public
cmnfeb	cmn	Chinese	cc
uigara	uig	Uyghur	cc
uigcyr	uig	Uyghur	cc
uigpin	uig	Uyghur	cc
uiglat	uig	Uyghur	cc
kwi	kwi	Awa-Cuaiquer	cc
bsnNT	bsn	Barasana-Eduria	cc
cbv	cbv	Cacua	cc
kbh	kbh	Camsá	cc
cbcNT	cbc	Carapana	cc
cubNT	cub	Cubeo	cc
cui	cui	Cuiba	cc
sjaNT	sja	Epena	cc
guh	guh	Guahibo	cc
gum	gum	Guambiano	cc
gvc	gvc	Guanano	cc
guoNT	guo	Guayabero	cc
hto	hto	Huitoto, Minica	cc
inb	inb	Inga	cc
myy	myy	Macuna	cc
bmrNT	bmr	Muinane	cc
pioNT	pio	Piapoco	cc
pirNT	pir	Piratapuyo	cc
snnNT	snn	Siona	cc
sri	sri	Siriano	cc
tnc	tnc	Tanimuca-Retuarã	cc
tav	tav	Tatuyo	cc
tuf	tuf	Tunebo, Central	cc
tue	tue	Tuyuca	cc
baoNT	bao	Waimaha	cc
noaE	noa	Woun Meu	cc
noaH	noa	Woun Meu	cc
ycn	ycn	Yucuna	cc
bzdNTpo	bzd	Bribri	cc
kyf	kyf	Kouya	cc
yreNT	yre	Yaouré	cc
hrv	hrv	Croatian	public
ronludari	ron	Romanian	cc
ces1613	ces	Czech	public
ceslb	ces	Czech	cc
cesnkb	ces	Czech	cc
yom	yom	Kiyombi	cc
lin	lin	Lingála	cc
dan1931	dan	Danish	public
cbiNTpo	cbi	Chachi	cc
conNTpo	con	Cofán	cc
cofNT	cof	Colorado	cc
qvzNT	qvz	Quichua, Northern Pastaza	cc
seyNT	sey	Secoya	cc
jivNT	jiv	Shuar	cc
aucNT	auc	Waorani	cc
arbnav	arb	Arabic, Standard	cc
copbhc	cop	Coptic	public
copcnt	cop	Coptic	public
copshc	cop	Coptic	none
ekkpkp	ekk	Eestonian	cc
amh	amh	Amharic	none
bwo	bwo	Borna	cc
dwrENT	dwr	Dawro	cc
dwrNT	dwr	Dawro	cc
gmvNT	gmv	Gamo	cc
gmvRNT	gmv	Gamo	cc
gmvggm	gmv	Gamotso	cc
gofwftw	gof	Gofa	cc
gofENT	gof	Gofa	cc
gofRNT	gof	Gofa	cc
amf	amf	Hamer-Banna	cc
mdyeth	mdy	Male	cc
gaz	gaz	Oromo, West Central	cc
wal	wal	Wolaytta	cc
breBRG	bre	Breton	public
frasbl	fra	French	public
fraLSG	fra	French	public
francl	fra	French	cc
fra_fob	fra	French	public
deuelbbk	deu	German	cc
deu1912	deu	German, Standard	public
deu1951	deu	German, Standard	cc
deutkw	deu	German, Standard	public
deu-f35	deu	German, Standard	public
deuelo	deu	German, Standard	public
ncuNT	ncu	Chumburung	cc
ewe	ewe	eʋegbe	cc
xon	xon	Konkomba	cc
nkoNT	nko	Nkonya	cc
twi	twi	Twi	cc
aka	twi	Twi	cc
twiasante	twi	Twi	cc
grc-tisch	grc	Greek	public
grcbrent	grc	Greek, Ancient	public
grcbyz	grc	Greek, Ancient	public
grcmt	grc	Greek, Ancient	public
grcf35	grc	Greek, Ancient	cc
grcsbl	grc	Greek, Ancient	cc
grcsr	grc	Greek, Ancient	public
grctcgnt	grc	Greek, Ancient	public
grctr	grc	Greek, Ancient	public
cha	cha	Chamorro	public
acrNNT	acr	Achi	cc
acrTNT	acr	Achi	cc
acr-acc	acr	Achi	cc
aguBl	agu	Aguacateco	cc
knjNT	knj	Akateko	cc
caa	caa	Chorti	cc
cac	cac	Chuj	cc
ixlCNT	ixl	Ixil	cc
ixlNNT	ixl	Ixil	cc
jacNT	jac	Jakalteko	cc
qucNNT	quc	K'iche'	cc
qucTNT	quc	K'iche'	cc
quctt	quc	K'iche'	cc
cakENT	cak	Kaqchikel	cc
cak	cak	Kaqchikel	cc
cakCNT	cak	Kaqchikel	cc
cakNT	cak	Kaqchikel	cc
cakSNT	cak	Kaqchikel	cc
cakYNT	cak	Kaqchikel	cc
cakWNT	cak	Kaqchikel	cc
mamC	mam	Mam	cc
mamNT	mam	Mam	cc
pohNT	poh	Poqomchi'	cc
kekNT	kek	Q'eqchi'	cc
ttcNT	ttc	Tektiteko	cc
tzjE	tzj	Tz'utujil	cc
tzjNT	tzj	Tz'utujil	cc
uspNT	usp	Uspanteko	cc
bsp	bsp	Baga Sitemu	cc
fuf	fuf	Pular	cc
sus	sus	Susu	cc
susa	sus	Susu	cc
tod	tod	Toma	cc
yal	yal	Yalunka	cc
akeNT	ake	Akawaio	cc
wapNT	wap	Wapishana	cc
hat	hat	Haitian	public
hatbsa	hat	Haitian	cc
cabNT	cab	Garifuna	cc
jicNT	jic	Tol	cc
hun	hun	Magyar	cc
isl	isl	Icelandic	cc
ahr	ahr	Ahirani	cc
asmfb	asm	Assamese	cc
bpx	bpx	Bareli, Palya	cc
bhd	bhd	Bhadrawahi	cc
bht	bht	Bhattiyali	cc
bdv	bdv	Bodo Parja	cc
tczchongthu	tcz	Chin, Thado	cc
dso	dso	Desiya	cc
gaq	gaq	Gata'	cc
guj2017	guj	Gujarati	cc
bgc	bgc	Haryanvi	cc
hincv	hin	Hindi	cc
hin2017	hin	Hindi	cc
hoy	hoy	Holiya	cc
juy	juy	Juray	cc
kanokcv	kan	Kannada	cc
kan2017	kan	Kannada	cc
kxv	kxv	Kuvi	cc
lbm	lbm	Lodhi	cc
mal	mal	Malayalam	cc
mar	mar	Marathi	cc
mni	mni	Meitei	cc
unx	unx	Munda	cc
nag	nag	Naga Pidgin	cc
kfw	kfw	Naga, Kharam	cc
tvt	tvt	Naga, Tutsa	cc
nlx	nlx	Nahali	cc
ory	ory	Oriya	cc
bfz	bfz	Pahari, Mahasu	cc
pan	pan	Panjabi, Eastern	cc
peg	peg	Pengo	cc
sch	sch	Sakachep	cc
sankan	san	Saṃskṛtam	cc
sankhm	san	Saṃskṛtam	cc
sanmal	san	Saṃskṛtam	cc
sanori	san	Saṃskṛtam	cc
sanpun	san	Saṃskṛtam	cc
sansin	san	Saṃskṛtam	cc
santam	san	Saṃskṛtam	cc
santel	san	Saṃskṛtam	cc
santha	san	Saṃskṛtam	cc
santib	san	Saṃskṛtam	cc
sanurd	san	Saṃskṛtam	cc
sanvel	san	Saṃskṛtam	cc
sancol	san	Sanskrit	cc
sanias	san	Sanskrit	cc
sanbur	san	Sanskrit	cc
sanasm	san	Sanskrit	cc
sanben	san	Sanskrit	cc
sandev	san	Sanskrit	cc
sanguj	san	Sanskrit	cc
sanhk	san	Sanskrit	cc
saniso	san	Sanskrit	cc
sanitr	san	Sanskrit	cc
tamtcv	tam	Tamil	cc
tam2017	tam	Tamil	cc
tel2017	tel	Telugu	cc
malc	mal	മലയാളം	cc
alpNT	alp	Alune	cc
aaz	aaz	Amarasi	cc
amk	amk	Ambai	cc
blzNT	blz	Balantak	cc
ptu	ptu	Bambam	cc
beu	beu	Blagar	cc
row	row	Dela-Oenale	cc
nfa	nfa	Dhao	cc
hvn	hvn	Hawu	cc
hegNTpo	heg	Helong	cc
indags	ind	Indonesian	cc
ind	ind	Indonesian	cc
kjeNT	kje	Kisar	cc
mkn	mkn	Kupang Malay	cc
llg	llg	Lole	cc
lex	lex	Luang	cc
mqjNT	mqj	Mamasa	cc
nbq	nbq	Nggem	cc
rgu	rgu	Rikou	cc
tet	tet	Tetun	cc
txq	txq	Tii	cc
kkl	kkl	Yale, Kosarek	cc
yvaNT	yva	Yawa	cc
azb	azb	Azerbaijani, South	cc
glk	glk	Gilaki	cc
pesopcb	pes	Iranian Persian	cc
pesOPV	pes	Persian	public
aii	aii	Assyrian Neo-Aramaic	cc
ckb	ckb	Central Kurdish	cc
heblb	heb	Hebrew	cc
hbo	hbo	Hebrew	public
heb	heb	Hebrew	public
hboWLC	hbo	Hebrew	cc
ita1885	ita	Italian	public
ita1927	ita	Italian	public
jpn1965	jpn	Japanese	public
luo	luo	Dholuo	cc
kik	kik	Gikuyu	cc
spyNT	spy	Sabaot	cc
sxbNT	sxb	Suba	cc
arb-vd	arb	Arabic	public
lit	lit	Lithuanian	cc
tdx	tdx	Malagasy, Tandroy-Mahafaly	cc
nya	nya	Chichewa	cc
yao	yao	Chiyawo	cc
zlmKSZI	zlm	Malay	cc
ffm	ffm	Fulfulde, Maasina	cc
myk	myk	Sénoufo, Mamara	cc
spp	spp	Sénoufo, Supyire	cc
amuNT	amu	Amuzgo, Guerrero	cc
azgNT	azg	Amuzgo, San Pedro Amuzgos	cc
cya	cya	Chatino, Nopala	cc
ctaNT	cta	Chatino, Tataltepec	cc
ctpNT	ctp	Chatino, Western Highland	cc
ccoNT	cco	Chinantec, Comaltepec	cc
cnlNT	cnl	Chinantec, Lalana	cc
cleNT	cle	Chinantec, Lealao	cc
chzNTps	chz	Chinantec, Ozumacín	cc
cpaNT	cpa	Chinantec, Palantla	cc
chqNT	chq	Chinantec, Quiotepec	cc
csoNT	cso	Chinantec, Sochiapam	cc
cntNT	cnt	Chinantec, Tepetotutla	cc
cucNT	cuc	Chinantec, Usila	cc
ctucti	ctu	Chol	cc
ctu76	ctu	Chol	cc
ctuBl	ctu	Chol	cc
chdNT	chd	Chontal, Highland Oaxaca	cc
chfNT	chf	Chontal, Tabasco	cc
crnNT	crn	Cora, El Nayar	cc
cuxNT	cux	Cuicatec, Tepeuxila	cc
cutNT	cut	Cuicatec, Teutila	cc
husNT2005	hus	Huastec	cc
husNT1971	hus	Huastec	cc
huvNT	huv	Huave, San Mateo Del Mar	cc
hchNT	hch	Huichol	cc
lacNT	lac	Lacandon	cc
mazNT	maz	Mazahua, Central	cc
maqNT	maq	Mazatec, Chiquihuitlán	cc
mauNT	mau	Mazatec, Huautla	cc
majNT	maj	Mazatec, Jalapa de Díaz	cc
maaNT	maa	Mazatec, San Jerónimo Tecóatl	cc
vmyNT	vmy	Mazateco, Ayautla	cc
mcoNT	mco	Mixe, Coatlán	cc
mirNT	mir	Mixe, Isthmus	cc
mxqNT	mxq	Mixe, Juquila	cc
mxpNT	mxp	Mixe, Tlahuitoltepec	cc
mtoNT	mto	Mixe, Totontepec	cc
mibNT	mib	Mixtec, Atatláhuca	cc
mihNT	mih	Mixtec, Chayuco	cc
mizNT	miz	Mixtec, Coatzospan	cc
xtdNT	xtd	Mixtec, Diuxi-tilantongo	cc
mxtNT	mxt	Mixtec, Jamiltepec	cc
xtmNTpp	xtm	Mixtec, Magdalena Peñasco	cc
mieNT	mie	Mixtec, Ocotepec	cc
milNT	mil	Mixtec, Peñoles	cc
mioNT	mio	Mixtec, Pinotepa Nacional	cc
mjcNT	mjc	Mixtec, San Juan Colorado	cc
migNT	mig	Mixtec, San Miguel el Grande	cc
mksNT	mks	Mixtec, Silacayoapan	cc
mitNT	mit	Mixtec, Southern Puebla	cc
mxbNT	mxb	Mixtec, Tezoatlán	cc
mpmNT	mpm	Mixtec, Yosondúa	cc
nhwBl	nhw	Nahuatl, Huasteca Occidental	cc
nheNT	nhe	Nahuatl, Huasteca Oriental	cc
nguNT	ngu	Nahuatl, Guerrero	cc
azzNT	azz	Nahuatl, Highland Puebla	cc
nchBl	nch	Nahuatl, Huasteca Central	cc
nheBl	nhe	Nahuatl, Huasteca Oriental	cc
nclNT	ncl	Nahuatl, Michoacán	cc
nhyNT	nhy	Nahuatl, Northern Oaxaca	cc
ncjNT	ncj	Nahuatl, Northern Puebla	cc
nplNT	npl	Nahuatl, Southeastern Puebla	cc
nhgNT	nhg	Nahuatl, Tetelcingo	cc
nhiNT	nhi	Nahuatl, Zacatlán-Ahuacatlán-Tepetzintla	cc
otmNT	otm	Otomi, Eastern Highland	cc
otsNT	ots	Otomi, Estado de México	cc
oteNT	ote	Otomi, Mezquital	cc
otqNT	otq	Otomi, Querétaro	cc
otnNT	otn	Otomi, Tenango	cc
poeNT	poe	Popoloca, San Juan Atzingo	cc
plsNT	pls	Popoloca, San Marcos Tlalcoyalco	cc
poiNT	poi	Popoluca, Highland	cc
spabes	spa	Spanish	cc
spapddpt	spa	Spanish	cc
tacNT	tac	Tarahumara, Western	cc
teeNT	tee	Tepehua, Huehuetla	cc
tptNT	tpt	Tepehua, Tlachichilco	cc
ntpNT	ntp	Tepehuan, Northern	cc
stpNT	stp	Tepehuan, Southeastern	cc
tojNT	toj	Tojolabal	cc
tocNT	toc	Totonac, Coyutla	cc
tosNT	tos	Totonac, Highland	cc
topNT	top	Totonac, Papantla	cc
tkuNT	tku	Totonac, Upper Necaxa	cc
tooNT	too	Totonac, Xicotepec De Juárez	cc
trcNT	trc	Triqui, Copala	cc
tzotzc	tzo	Tzotzil	cc
tzotze	tzo	Tzotzil	cc
tzoNT	tzo	Tzotzil	cc
tzoSA	tzo	Tzotzil	cc
tzoZNT	tzo	Tzotzil	cc
yaqNT	yaq	Yaqui	cc
zpoNT	zpo	Zapotec, Amatlán	cc
zadNT	zad	Zapotec, Cajonos	cc
zpvNT	zpv	Zapotec, Chichicapan	cc
zpcNT	zpc	Zapotec, Choapan	cc
zcaNT	zca	Zapotec, Coatecas Altas	cc
zaiNT	zai	Zapotec, Isthmus	cc
zplNT	zpl	Zapotec, Lachixío	cc
zamNT	zam	Zapotec, Miahuatlán	cc
zpmNT	zpm	Zapotec, Mixtepec	cc
zacNT	zac	Zapotec, Ocotlán	cc
zaoNT	zao	Zapotec, Ozolotepec	cc
ztqNT	ztq	Zapotec, Quioquitani-Quierí	cc
zarNT	zar	Zapotec, Rincón	cc
zabNT	zab	Zapotec, San Juan Guelavía	cc
zapNT	zpi	Zapotec, Santa María Quiegolani	cc
zasNT	zas	Zapotec, Santo Domingo Albarradas	cc
zaaNT	zaa	Zapotec, Sierra de Juárez	cc
zsrNT	zsr	Zapotec, Southern Rincon	cc
zatNTps	zat	Zapotec, Tabaa	cc
zpzNTpp	zpz	Zapotec, Texmelucan	cc
zpuNT	zpu	Zapotec, Yalálag	cc
ztyNTps	zty	Zapotec, Yatee	cc
zavNT	zav	Zapotec, Yatzachi	cc
zpqNT	zpq	Zapotec, Zoogocho	cc
zosNT	zos	Zoque, Francisco León	cc
chk	chk	Chuukese	cc
kpg	kpg	Kapingamarangi	cc
kos	kos	Kosraean	public
mkj	mkj	Mokilese	cc
pon2006	pon	Pohnpeian	cc
pon2006a	pon	Pohnpeian	cc
pon-pdn	pon	Pohnpeian	public
pon	pon	Pohnpeian	public
uli	uli	Ulithian	cc
yap	yap	Yapese	cc
eko	eko	Kote	cc
mgh	mgh	Makhuwa-Meetto	cc
mgh2016	mgh	Makhuwa-Meetto	cc
kde	kde	Makonde	cc
wmw	wmw	Mwani	cc
seh	seh	Sena	cc
tke	tke	Takwane	cc
mya	mya	Burmese	public
myajvb	mya	Burmese	public
dao	dao	Chin, Daai	cc
cekak	cek	Chin, Eastern Khumi	public
hltmcsb	hlt	Chin, Matu	cc
hlt	hlt	Chin, Matu	public
hltthb	hlt	Chin, Matu	cc
csy	csy	Chin, Siyin	cc
cth	cth	Chin, Thaiphum	cc
zypNT	zyp	Chin, Zyphe	cc
atbNT	atb	Zaiwa	cc
sbs	sbs	Kuhane	cc
lifNT2	lif	Limbu	cc
lifNT	lif	Limbu	cc
npiulb	npi	Nepali	cc
suzBl	suz	Sunwar	cc
taj	taj	Tamang, Eastern	cc
nld	nld	Dutch	public
nld1939	nld	Dutch	public
priNT	pri	Paicî	cc
amo	amo	Amo	cc
bsj	bsj	Bangwinji	cc
bqcsim	bqc	Boko	cc
bus	bus	Bokobaru	cc
jid	jid	Bu	cc
bqp	bqp	Busa	cc
hausa	hau	Hausa	cc
hauulb	hau	Hausa	cc
ibo	ibo	Igbo	cc
ikkNT	ikk	Ika	cc
ikwNT	ikw	Ikwere	cc
atgNT	atg	Ivbie North-Okpela-Arhe	cc
jni	jni	Janji	cc
ninNT	nin	Ninzo	cc
kdlNT	kdl	Tsikimba	cc
tswNT	tsw	Tsishingini	cc
yor	yor	Yorùbá	cc
noblb	nob	Norwegian	cc
urdgvr	urd	Urdu	cc
urdgvu	urd	Urdu	cc
urdgvh	urd	Urdu	cc
urd	urd	Urdu	cc
sabNT	sab	Buglere	cc
empNTpo	emp	Emberá, Northern	cc
kvnNT	kvn	Kuna, Border	cc
cuk09	cuk	Kuna, San Blas	cc
gymNT	gym	Ngäbere	cc
cuk	cuk	San Blas Kuna	cc
tfrNTpo	tfr	Teribe	cc
kud	kud	'Auhelawa	cc
aau	aau	Abau	cc
adz	adz	Adzera	cc
agd	agd	Agarabi	cc
spm	spm	Akukem	cc
amp	amp	Alamblak	cc
gah	gah	Alekano or Gahuku	cc
amm	amm	Ama	cc
amn-n	amn	Amanab	cc
amn-amanab	amn	Amanab	cc
abt-maprik	abt	Ambulas	cc
aey	aey	Amele	cc
aby	aby	Aneme Wake	cc
agm	agm	Angaataha	cc
agg	agg	Angor	cc
boj	boj	Anjam	cc
boj2014	boj	Anjam	cc
aak	aak	Ankave	cc
aui	aui	Anuki	cc
aon	aon	Arapesh	cc
mwc	mwc	Are	cc
apr	apr	Arop-Lokep	cc
msy2020	msy	Aruamu	cc
msy	msy	Aruamu	cc
avt	avt	Au	cc
awb	awb	Awa	cc
awx	awx	Awara	cc
auy	auy	Awiyaana	cc
bbb	bbb	Barai	cc
mlp	mlp	Bargam	cc
bch	bch	Bariai	cc
bjk	bjk	Barok	cc
bjz	bjz	Baruga	cc
byr	byr	Baruya	cc
bbd	bbd	Bau	cc
beo	beo	Beami	cc
bef	bef	Benabena	cc
big	big	Biangai	cc
big2013	big	Biangai	none
bhl	bhl	Bimin	cc
bhg	bhg	Binandere	cc
bon	bon	Bine	cc
bjr	bjr	Binumarien	cc
mux	mux	Bo-Ung	cc
bnp	bnp	Bola	cc
gai	gai	Borei	cc
ksr	ksr	Borong	cc
bzh	bzh	Buang	cc
mmo	mmo	Buang, Mangga	cc
bxh	bxh	Buhutu	cc
buk	buk	Bukawa	cc
apeB	ape	Bukiyip	cc
apec	ape	Bukiyip	cc
bdd	bdd	Bunama	cc
tte	tte	Bwanabwana	cc
tteo	tte	Bwanabwana	cc
cjv	cjv	Chuave	cc
mps	mps	Dadibi	cc
dgz	dgz	Daga	cc
aso	aso	Dano	cc
dww	dww	Dawawa	cc
ded	ded	Dedua	cc
dob	dob	Dobu	cc
kqc	kqc	Doromu-Koki	cc
kjs	kjs	East Kewa	cc
etr	etr	Edolo	cc
enq2	enq	Enga	cc
enq	enq	Enga	cc
mcq	mcq	Ese or Managalasi	cc
nou	nou	Ewage-Notu	cc
fai	fai	Faiwol	cc
bjp	bjp	Fanamaket	cc
faa	faa	Fasu	cc
aoj-filifita	aoj	Filifita dialect of Mufian	cc
ppo	ppo	Folopa	cc
for	for	Fore	cc
pwg	pwg	Gapapaiwa	cc
bmk	bmk	Ghayavi	cc
bbr	bbr	Girawa	cc
bbr2013	bbr	Girawa	none
tof	tof	Gizrra	cc
gvf	gvf	Golin	cc
ghs	ghs	Guhu-Samane	cc
gvs	gvs	Gumawana	cc
dah	dah	Gwahatike	cc
hla	hla	Halia	cc
wos	wos	Hanga Hundi	cc
tmd	tmd	Haruai	cc
hui	hui	Huli	cc
yml	yml	Iamalele	cc
ian	ian	Iatmul	cc
viv	viv	Iduna	cc
imo	imo	Imbo Ungu	cc
ino	ino	Inoke-Yate	cc
ino2013	ino	Inoke-Yate	none
ipi	ipi	Ipili	cc
kbm	kbm	Iwal	cc
iws	iws	Iwam, Sepik	cc
nca	nca	Iyo	cc
kqf	kqf	Kakabai	cc
kmh	kmh	Kalam	cc
bco	bco	Kaluli	cc
kbq	kbq	Kamano	cc
kms	kms	Kamasau	cc
xla	xla	Kamula	cc
soq	soq	Kanasi	cc
kqw	kqw	Kandas	cc
gam	gam	Kandawo	cc
wat	wat	Kaninuwa	cc
kmu	kmu	Kanite	cc
leu	leu	Kara	cc
yuj	yuj	Karkar-Yuri	cc
khs	khs	Kasua	cc
kmg	kmg	Kate	cc
ksd	ksd	Kauana	cc
khz	khz	Keapara	cc
bmh	bmh	Kein	cc
kyg	kyg	Keyagana	cc
kij	kij	Kilivila	cc
geb	geb	Kire	cc
kiw	kiw	Kiwai, Northeast	cc
kpw	kpw	Kobon	cc
kpx	kpx	Koiali, Mountain	cc
kpf	kpf	Komba	cc
xbi-w	xbi	Kombio	cc
xbi-y	xbi	Kombio	cc
kxw	kxw	Konai	none
kpr	kpr	Korafe	cc
kze	kze	Kosena	cc
kgf	kgf	Kube	cc
kue	kue	Kuman	cc
kvg	kvg	Kuni-Boazi	cc
kup	kup	Kunimaipa	cc
kto	kto	Kuot	cc
ktm	ktm	Kurti	cc
kwj	kwj	Kwanga	cc
kmo	kmo	Kwoma	cc
kyc	kyc	Kyaka Enga	cc
kql	kql	Kyenele	cc
lbb	lbb	Label	cc
uvl	uvl	Lote	cc
mmx	mmx	Madak	cc
mzz	mzz	Maiadomu	cc
mti	mti	Maiwa	cc
hot	hot	Malei-Hote	cc
mva	mva	Manam	cc
mle	mle	Manambu	cc
tbf	tbf	Mandara	cc
mbh	mbh	Mangseng	cc
mlh	mlh	Mape	cc
dad	dad	Marik	cc
met	met	Mato	cc
mhl	mhl	Mauwake	cc
mna	mna	Mbula	cc
mek	mek	Mekeo	cc
tpiOTNT	tpi	Melanesian Pidgin	cc
tpi	tpi	Melanesian Pidgin	cc
med	med	Melpa	cc
sim	sim	Mende	cc
mee	mee	Mengen	cc
mcr	mcr	Menya	cc
mpt	mpt	Mian	cc
mpp	mpp	Migabac	cc
mvn	mvn	Minaveha	cc
aai	aai	Miniafia	cc
kmh-m	kmh	Minimib dialect of Kalam	cc
mpx	mpx	Misima-Paneati	cc
mox	mox	Molima	cc
meu	meu	Motu	cc
hmo	hmo	Motu, Hiri	cc
aoj	aoj	Mufian	cc
kqa	kqa	Mum	cc
emi	emi	Mussau-Emira	cc
tuc-o	tuc	Mutu	cc
tuc-t	tuc	Mutu	cc
myw	myw	Muyuw	cc
nas	nas	Naasioi	cc
naf	naf	Nabak	cc
nak	nak	Nakanai	cc
nss	nss	Nali	cc
nvm	nvm	Namiae	cc
nsn	nsn	Nehan	cc
nif	nif	Nek	cc
anh	anh	Nend	cc
nii	nii	Nii	cc
gaw	gaw	Nobonob	cc
tbg-a	tbg	North Tairora	cc
klt	klt	Nukna	cc
nuq	nuq	Nukumanu	none
nop	nop	Numanggang	cc
lid	lid	Nyindrou	cc
kkc	kkc	Odoodee	cc
eri	eri	Ogea	cc
opm	opm	Oksapmin	cc
ong	ong	Olo	cc
aom	aom	Omie	cc
omw-v	omw	Omwunra-Toqura or South Tairora	cc
ons	ons	Ono	cc
okvh	okv	Orokaiva	cc
okv	okv	Orokaiva	cc
ptp	ptp	Patep	cc
gfkh	gfk	Patpatar	cc
gfk	gfk	Patpatar	cc
gfks	gfk	Patpatar	cc
ata	ata	Pele-Ata	cc
byx	byx	Qaqet	cc
rai	rai	Ramoaaina	cc
rwo-karo	rwo	Rawa	cc
rwo-rawa	rwo	Rawa	cc
nmws	nmw	Rifao	cc
roo	roo	Rotokas	cc
apz	apz	Safeyoka	cc
sbe	sbe	Saliba	cc
sll	sll	Salt-Yui	cc
snx	snx	Sam	cc
sny	sny	Saniyo-Hiyewe	cc
sps	sps	Saposa	cc
ssg	ssg	Seimat	cc
spl	spl	Selepet	cc
ssx	ssx	Sembeleke	cc
snp	snp	Siane	cc
snp-lambau	snp	Siane	cc
snc	snc	Sinaugoro	cc
xsi	xsi	Sio	cc
ssd	ssd	Siroi	cc
bmu	bmu	Somba-Siawari or Burum-Mindik	cc
urw	urw	Sop	cc
omw-a	omw	South Tairora	cc
swp	swp	Suau	cc
tgo	tgo	Sudest	cc
sue	sue	Suena	cc
sua	sua	Sulka	cc
sgz	sgz	Sursurunga	cc
knv-aramia	knv	Tabo	cc
knv-fly_river	knv	Tabo	cc
taw	taw	Tai	cc
tbg	tbg	Tairora	cc
omw	omw	Tairora, South	cc
tbc	tbc	Takia	cc
nho	nho	Takuu	cc
tpa	tpa	Taupota	cc
tbo	tbo	Tawala	cc
tlf	tlf	Telefol	cc
tif	tif	Tifal	cc
tim	tim	Timbe	cc
tpz	tpz	Tinputz	cc
iou	iou	Tuma-Irumu	cc
lcm	lcm	Tungag	cc
ksj	ksj	Uare	cc
ubr	ubr	Ubir	cc
gdn	gdn	Umanakaina	cc
ubu-andelale	ubu	Umbu-Ungu	cc
ubu-kala	ubu	Umbu-Ungu	cc
ubu-nopenge	ubu	Umbu-Ungu	cc
urt	urt	Urat	cc
uvh	uvh	Uri	cc
uri	uri	Urim	cc
wnu	wnu	Usan	cc
usa	usa	Usarufa	cc
wiv	wiv	Vitu	cc
waj	waj	Waffa	cc
fad	fad	Wagi	none
rro	rro	Waima	cc
wnc	wnc	Wantoat	cc
wrs	wrs	Waris	cc
wsk	wsk	Waskia	cc
wed	wed	Wedau	cc
wed-topura	wed	Wedau	cc
wer	wer	Weri	cc
kew	kew	West Kewa	cc
gdr	gdr	Wipi	cc
wiu	wiu	Wiru	cc
abt-wosera	abt	Wosera-Kamu dialect of Ambulas	cc
wuv	wuv	Wuvalu-Aua	cc
jae	jae	Yabem	cc
yrb	yrb	Yareba	cc
yuw	yuw	Yau	cc
yby	yby	Yaweyuha	cc
yle	yle	Yele	cc
yss-yamano	yss	Yessan-Mayo	cc
yss-yawu	yss	Yessan-Mayo	cc
byr-w	byr	Yipma	cc
yon	yon	Yongkom	cc
yut	yut	Yopno	cc
zia	zia	Zia	cc
kud2014	kud	’Auhelawa	none
mca	mca	Maka	cc
acuNT	acu	Achuar-shiwiar	cc
agr	agr	Aguaruna	cc
cpcNT	cpc	Ajyíninka Apurucayali	cc
amrNT	amr	Amarakaeri	cc
arlNT	arl	Arabela	cc
cniNT	cni	Asháninka	cc
cjoNT	cjo	Ashéninka Pajonal	cc
cpuNT	cpu	Ashéninka, Pichis	cc
cpy	cpy	Ashéninka, South Ucayali	cc
cpbNT	cpb	Ashéninka, Ucayali-yurúa	cc
boaNT	boa	Bora	cc
cbuNT	cbu	Candoshi-Shapra	cc
kaqNT	kaq	Capanahua	cc
cbrNT	cbr	Cashibo-Cacataibo	cc
cbtNTpo	cbt	Chayahuita	cc
hubNT	hub	Huambisa	cc
huuNT	huu	Huitoto, Murui	cc
cbsNT	cbs	Kashinawa	cc
mcbNT	mcb	Machiguenga	cc
mcfNT	mcf	Matsés	cc
notNT	not	Nomatsiguenga	cc
qvcNT	qvc	Quechua, Cajamarca	cc
qveNT	qve	Quechua, Eastern Apurímac	cc
qub	qub	Quechua, Huallaga Huánuco	cc
qvhNT	qvh	Quechua, Huamalíes-Dos de Mayo Huánuco	cc
qwhNT	qwh	Quechua, Huaylas Ancash	cc
qvwNT	qvw	Quechua, Huaylla Wanca	cc
qufNT	quf	Quechua, Lambayeque	cc
qvmNT	qvm	Quechua, Margos-Yarowilca-Lauricocha	cc
qvnNT	qvn	Quechua, North Junín	cc
qxnNT	qxn	Quechua, Northern Conchucos Ancash	cc
qxhNT	qxh	Quechua, Panao Huánuco	cc
qvsNT	qvs	Quechua, San Martín	cc
qxoNT	qxo	Quechua, Southern Conchucos Ancash	cc
qupNT	qup	Quechua, Southern Pastaza	cc
mcdNT	mcd	Sharanahua	cc
shpNTpo	shp	Shipibo-Conibo	cc
tcaNT	tca	Ticuna	cc
uraNT	ura	Urarina	cc
yadNT	yad	Yagua	cc
yaaNT	yaa	Yaminahua	cc
ameNT	ame	Yanesha'	cc
pibNT	pib	Yine	cc
dgc	dgc	Agta, Casiguran Dumagat	cc
agt	agt	Agta, Central Cagayan	cc
agn	agn	Agutaynen	cc
att	att	Atta, Pamplona	cc
sgb	sgb	Ayta, Mag-antsi	cc
blw	blw	Balangao	cc
bkd	bkd	Binukid	cc
bpr	bpr	Blaan, Koronadal	cc
bps	bps	Blaan, Sarangani	cc
smkNT	smk	Bolinao	cc
lbk	lbk	Bontok, Central	cc
ebk	ebk	Bontok, Eastern	cc
clu	clu	Caluyanun	cc
cebulb	ceb	Cebuano	cc
cbk	cbk	Chavacano	cc
iloulb	ilo	Ilocano	cc
abx	abx	Inabaknon	cc
cgc	cgc	Kagayanen	cc
kmk	kmk	Kalinga, Limos	cc
kne	kne	Kankanaey	cc
xnn	xnn	Kankanay, Northern	cc
msmNT	msm	Manobo, Agusan	cc
atdNT	atd	Manobo, Ata	cc
mbtNT	mbt	Manobo, Matigsalug	cc
oboNT	obo	Manobo, Obo	cc
mbs	mbs	Manobo, Sarangani	cc
mbbOT	mbb	Manobo, Western Bukidnon	cc
msk	msk	Mansaka	cc
msb	msb	Masbatenyo	cc
prfNT	prf	Paranan	cc
bgs	bgs	Tagabawa	cc
tglulb	tgl	Tagalog	cc
tblNT	tbl	Tboli	cc
tiy	tiy	Tiruray	cc
yka	yka	Yakan	cc
epo	epo	Esperanto	public
polubg	pol	Polish	cc
polsz	pol	Polski	cc
ronBayash	ron	Romanian	cc
ron1924	ron	Romanian	public
ronlsb	ron	Romanian	public
kca	kca	Khanty	cc
russyn	rus	Russian	public
acfNT	acf	Saint Lucian Creole French	cc
knf	knf	Mankanya	cc
wolKYG	wol	Wolof	cc
wol2010	wol	Wolof	cc
rmyArli	rmy	Romani, Vlax	cc
rmyChergash	rmy	Romani, Vlax	cc
rmyGurbet	rmy	Romani, Vlax	cc
srp1865	srp	Serbian	public
rmc	rmc	Romani, Carpathian	cc
aia	aia	Arosi	cc
bvd	bvd	Baeggu	cc
bgt	bgt	Bughotu	cc
far	far	Fataleka	cc
nlg	nlg	Gela	cc
kwd	kwd	Kwaio	cc
kwf	kwf	Kwara'ae	cc
ntu	ntu	Natügu	cc
rug	rug	Roviana	cc
apb	apb	Sa'a	cc
lgl	lgl	Wala	cc
som	som	Somali	cc
mgc	mgc	Morokodo	cc
spaRV1909	spa	Spanish	public
sparvg	spa	Spanish	cc
spablm	spa	Spanish	public
spavbl	spa	Spanish	cc
dikNT	dik	Dinka, Southwestern	cc
shj	shj	Shatt	cc
udu	udu	Uduk	cc
carNT	car	Carib	cc
djkNT	djk	Eastern Maroon Creole	cc
hnsNT	hns	Hindustani, Caribbean	cc
jvnNT	jvn	Javanese, Caribbean	cc
srmNT	srm	Saramaccan	cc
srnNT	srn	Sranan	cc
swe	swe	Swedish	cc
tgk	tgk	Tajik	cc
isn	isn	Isanzu	cc
reg	reg	Kara	cc
zgam	zga	Kinga	cc
kiz	kiz	Kisi	cc
swhonen	swh	Kiswahili	cc
kdc	kdc	Kutu	cc
cwe	cwe	Kwere	cc
ruf	ruf	Luguru	cc
mgw	mgw	Matumbi	cc
mwe	mwe	Mwera	cc
ndj	ndj	Ndamba	cc
ndg	ndg	Ndengereko	cc
nnq	nnq	Ngindo	cc
xnj	xnj	Ngoni	cc
ngp	ngp	Nguu	cc
poy	poy	Pogolo	cc
sbk	sbk	Safwa	cc
swh1850	swh	Swahili	public
swhulb	swh	Swahili	cc
vid	vid	Vidunda	cc
wbi	wbi	Vwanji	cc
zaj	zaj	Zaramo	cc
ziw	ziw	Zigua	cc
thaKJV	tha	Thai	cc
bkx	bkx	Baikeno	cc
tdt	tdt	Tetun Dili	cc
gngNT	gng	Ngangam	cc
ton	ton	Tongan	public
turev	tur	Turkish	public
lug	lug	Luganda	cc
rmyvlakh	rmy	Romani	cc
rmylovari	rmy	Romani	cc
rmczrb	rmc	Romani, Carpathian	cc
rmyservi	rmy	Romani, Vlax	cc
ukr1996	ukr	Ukrainian	none
ukr1871	ukr	Ukrainian	public
ukronpu	ukr	Ukranian	cc
engaoi	eng	English	cc
engBBE	eng	English	public
eng-Brenton	eng	English	public
eng-uk-lxx2012	eng	English	public
engDBY	eng	English	public
engDRA	eng	English	public
engemtv	eng	English	cc
engwyc2018	eng	English	cc
engwyc2017	eng	English	cc
enggnv	eng	English	public
eng-kjv2006	eng	English	public
eng-kjv	eng	English	public
engkjvcpb	eng	English	public
englee	eng	English	public
engnoy	eng	English	public
engoebcw	eng	English	public
eng-rv	eng	English	public
engoke	eng	English	public
engtnt	eng	English	public
engwebpb	eng	English	public
eng-webbe	eng	English	public
engwmbb	eng	English	public
engWycliffe	eng	English	public
engylt	eng	English	public
apwNT	apw	Apache, Western	cc
arp	arp	Arapaho	public
eng-asv	eng	English	public
engasvbt	eng	English	public
englsv	eng	English	cc
eng-glw	eng	English	cc
eng-lxx2012	eng	English	public
engnet	eng	English	none
engourb	eng	English	cc
engoebus	eng	English	public
engtcent	eng	English	cc
eng-t4t	eng	English	cc
engULB	eng	English	cc
engwebster	eng	English	public
engwebp	eng	English	public
eng-web-c	eng	English	public
eng-web	eng	English	public
engwmb	eng	English	public
gwiNT	gwi	Gwich'in	cc
haw1868	haw	Hawaiian	public
hopNT	hop	Hopi	cc
paoNT	pao	Paiute, Northern	cc
gulNT	gul	Sea Island Creole English	cc
tew	tew	Tewa	cc
oodNT	ood	Tohono O'odham	cc
engbsb	eng	English	cc
engf35	eng	English	cc
engfbv	eng	English	cc
engjps	eng	English	public
englxxup	eng	English	public
eskNT	esk	Northwest Alaska Eskimo	cc
tvk	tvk	Ambrym, Southeast	cc
bki	bki	Baki	cc
lww	lww	Lewo	cc
klv	klv	Maskelynes	cc
tnk	tnk	Nafe	cc
tnn	tnn	North Tanna	cc
pma	pma	Paama	cc
nwi	nwi	Southwest Tanna	cc
tgp	tgp	Tangoa	cc
upv	upv	Uripiv-Wala-Rano-Atchin	cc
tnp	tnp	Whitesands	cc
latVUC	lat	Latin	public
vieovcb	vie	Tiếng Việt	cc
vie1934	vie	Vietnamese	public
sna	sna	chiShona	cc
dov	dov	Dombe	cc
nde	nde	Ndebele	cc
